|--------|
|...|..-.|
|.._|.@..|
|......-.|
|--------|